# old_path	new_category
agent-infrastructure/a2a-platform	agent-orchestration
agent-infrastructure/agent-task-tracker	agent-core
agent-infrastructure/anyone-proxy	agent-core
agent-infrastructure/autonomous-execution	agent-orchestration
agent-infrastructure/clawdhub-skill	media-processing
agent-infrastructure/clawlist	agent-core
agent-infrastructure/context-anchor	agent-core
agent-infrastructure/dgr	agent-core
agent-infrastructure/glin-profanity-mcp	security-compliance
agent-infrastructure/hello-agent-world	agent-core
agent-infrastructure/hello-world	agent-core
agent-infrastructure/ibt	agent-core
agent-infrastructure/interclaw	agent-orchestration
agent-infrastructure/mcporter-skill	integrations-connectors
agent-infrastructure/memory-tiering	agent-core
agent-infrastructure/mi-habilidad-nueva	agent-core
agent-infrastructure/recursive-self-improvement	agent-core
agent-infrastructure/shodh-local	agent-core
agent-infrastructure/task	agent-core
ai-agent-orchestration/a2a-hub	agent-orchestration
ai-agent-orchestration/apoer-agent-guardrail	security-compliance
ai-agent-orchestration/aws-agentcore-langgraph	agent-core
ai-agent-orchestration/brainstorming-2	agent-orchestration
ai-agent-orchestration/context-aware-delegation	agent-orchestration
ai-agent-orchestration/daily-oracle	agent-orchestration
ai-agent-orchestration/delegation	agent-orchestration
ai-agent-orchestration/dynamic-model-selector	agent-orchestration
ai-agent-orchestration/kalibr	agent-orchestration
ai-agent-orchestration/kimi-delegation-skill	agent-orchestration
ai-agent-orchestration/kindroid-interact	agent-orchestration
ai-agent-orchestration/llm-supervisor	agent-orchestration
ai-agent-orchestration/lygo-champion-401lyrakin-voice-between	agent-orchestration
ai-agent-orchestration/manipulation-detector	agent-orchestration
ai-agent-orchestration/rey-model-router	agent-orchestration
ai-agent-orchestration/smart-spawn	agent-orchestration
ai-agent-orchestration/ydc-claude-agent-sdk-integration	agent-orchestration
ai-agent-orchestration/zero-trust	security-compliance
ai-media-generation/clonev	media-generation
ai-media-generation/comfyui-tts	media-generation
ai-media-generation/deepdub-tts	media-generation
ai-media-generation/fal	media-generation
ai-media-generation/ffmpeg-cli	media-generation
ai-media-generation/ffmpeg-master	media-processing
ai-media-generation/free-groq-voice	media-processing
ai-media-generation/gemini-image-remix	media-generation
ai-media-generation/grok-image-cli	media-generation
ai-media-generation/image-and-video-generation-vydra	media-generation
ai-media-generation/image-router	agent-orchestration
ai-media-generation/lb-pocket-tts-skill	media-generation
ai-media-generation/livekit	media-generation
ai-media-generation/lunara-voice	media-generation
ai-media-generation/mac-tts	media-generation
ai-media-generation/macos-local-voice	media-generation
ai-media-generation/parakeet-mlx	media-processing
ai-media-generation/sarvam	media-generation
ai-media-generation/say	media-generation
ai-media-generation/speechall-cli	media-processing
ai-media-generation/table-image	media-generation
ai-media-generation/vision-sandbox	devops-cloud
ai-media-generation/vision-tagger	media-generation
ai-media-generation/vlmrun-cli-skill	media-generation
ai-media-generation/whisper-transcribe	agent-orchestration
ai-media-generation/yap	media-processing
ai-media-generation/yollomi	media-generation
automation/abm-outbound	business-operations
automation/airtable-automation	integrations-connectors
automation/apollo	business-operations
automation/basecamp-automation	integrations-connectors
automation/clawconnect	integrations-connectors
automation/cold-email	content-publishing
automation/composio-connect	integrations-connectors
automation/cpc-mpqc-competence-tracker-compliance-uk	productivity-personal
automation/customer-crm	productivity-personal
automation/dropshipping-mentor-nick-skill	business-operations
automation/finishing-a-development-branch	productivity-personal
automation/human-negotiator	content-publishing
automation/kakiyo	data-analytics
automation/pollclaw	productivity-personal
automation/quality-gate	devops-cloud
automation/reasoning-personas	productivity-personal
automation/receiving-code-review	developer-tools
automation/senior-dev	agent-core
automation/tokportal	data-analytics
automation/verification-checkpoint	agent-core
browser-automation/agent-browser-stagehand	browser-automation
browser-automation/autofillin	browser-automation
browser-automation/blankfiles	browser-automation
browser-automation/browser-automation-skill	browser-automation
browser-automation/browser-pc	browser-automation
browser-automation/browser-use-local	search-web
browser-automation/ddg	agent-core
browser-automation/ddg-web-search	search-web
browser-automation/exa	search-web
browser-automation/exa-search	search-web
browser-automation/flash-redeem-knight	browser-automation
browser-automation/gitclassic	browser-automation
browser-automation/links-to-pdfs	browser-automation
browser-automation/nl2ms-ui	browser-automation
browser-automation/riddle	browser-automation
browser-automation/stagehand-browser-cli	browser-automation
browser-automation/tinyfish-web-agent	browser-automation
browser-automation/web-form-automation	browser-automation
business-data-integration/backup-gog-20260213-121122	integrations-connectors
business-data-integration/camino-journey	travel-transport
business-data-integration/clawdiligence	finance-markets
business-data-integration/gog-jasmine	integrations-connectors
business-data-integration/intelligence-suite	data-analytics
business-data-integration/intomd	media-processing
business-data-integration/karakeep	business-operations
business-data-integration/m365-pnp-cli	integrations-connectors
business-data-integration/noopolis	business-operations
business-data-integration/office-secretary	productivity-personal
business-data-integration/pubmed2blog	content-publishing
business-data-integration/samsung-health	productivity-personal
business-data-integration/seo-autopilot	content-publishing
business-data-integration/vivid-business-account-opening	business-operations
business-integration/clawpify	business-operations
business-integration/hylo-ghl	business-operations
business-integration/karakeep-sh	business-operations
business-integration/ourproject-openclaw-skill	business-operations
business-integration/pamela-call	business-operations
business-integration/product-marketing-context	business-operations
business-integration/productboard-search	business-operations
business-integration/property-search	travel-transport
business-integration/research-idea	knowledge-research
business-integration/researchassistant	knowledge-research
business-integration/saas-orchestrator	agent-orchestration
business-integration/saas-worker	data-analytics
business-integration/salesforce-dx	business-operations
business-integration/salesforce-sdr-admin	business-operations
business-integration/talkspresso	productivity-personal
business-integration/wooclaw-lite	business-operations
cloud-network/aliyun-oss-upload	devops-cloud
cloud-network/host-ping-detect	devops-cloud
cloud-network/mfa-word	security-compliance
cloud-network/say-xiaoai	devops-cloud
cloud-network/sparkle-vpn	devops-cloud
cloud-network/win-mouse-native	knowledge-research
communication-email/ai-conversation-summary	agent-core
communication-email/chat-conversation-summary	agent-core
communication-email/dada-conv-summary	agent-core
communication-email/dada-conversation-summary	agent-core
communication-email/elevenlabs-transcribe	media-processing
communication-email/gmail-client	communication-messaging
communication-email/himalaya	communication-messaging
communication-email/himalaya-cli	communication-messaging
communication-email/meetgeek	communication-messaging
communication/avatar	media-generation
communication/cma-email	communication-messaging
communication/communication-mqtt	communication-messaging
communication/custom-smtp-sender	communication-messaging
communication/discord-chat	communication-messaging
communication/dm-bot	communication-messaging
communication/feishu-leave-request	communication-messaging
communication/flomo-notes	communication-messaging
communication/gog-html-email	communication-messaging
communication/gowa	communication-messaging
communication/humanize-zh	communication-messaging
communication/imap-email	communication-messaging
communication/imap-smtp-email	communication-messaging
communication/juejin-article-trends	communication-messaging
communication/katok	communication-messaging
communication/lark-bot-listener	communication-messaging
communication/lark-custom-bot	communication-messaging
communication/liveavatar	media-generation
communication/localsend	communication-messaging
communication/mailchannels	communication-messaging
communication/news-summary	knowledge-research
communication/ocft	communication-messaging
communication/olvid-channel	communication-messaging
communication/openclaw-skills-newsboat	knowledge-research
communication/outlook-email	communication-messaging
communication/pamela-calls	business-operations
communication/pocketalert	communication-messaging
communication/protonmail	communication-messaging
communication/remindme	communication-messaging
communication/send-email	communication-messaging
communication/send-email-2	communication-messaging
communication/signal-cli	communication-messaging
communication/signl4	communication-messaging
communication/style-polisher	communication-messaging
communication/tamil-whatsapp	communication-messaging
communication/telegram-ascii-table	communication-messaging
communication/teltel-send-sms-text-message	communication-messaging
communication/temp-mail	communication-messaging
communication/tt	communication-messaging
communication/vexa	media-processing
communication/wechat-article-search	communication-messaging
communication/whats	communication-messaging
communication/whatsmolt	content-publishing
communication/whisper	agent-orchestration
communication/whiss	communication-messaging
communication/zulip	communication-messaging
content-media/auteng-docs-curl-publish	content-publishing
content-media/bilibili-update-viewer	knowledge-research
content-media/cctv-news-fetcher	knowledge-research
content-media/daily-dxc-briefing	knowledge-research
content-media/daily-news	knowledge-research
content-media/deepread	media-processing
content-media/markdown-publish-share	content-publishing
content-media/moltbook-cli-tool	content-publishing
content-media/pandoc-convert-openclaw	media-processing
content-media/paper-parse	knowledge-research
content-media/ppt-generator	media-generation
content-media/ralph-loop-writer	developer-tools
content-media/resume-builder	content-publishing
content-media/slidespeak	media-generation
content-media/solobuddy	content-publishing
content-media/test-materials	developer-tools
content-media/toutiao-news-trends	knowledge-research
content-media/zerox	media-processing
content-social/agent-voice	content-publishing
content-social/baoyu-post-to-x	content-publishing
content-social/bot-debate	content-publishing
content-social/botmadang	content-publishing
content-social/chaterimo-openclaw-skill	communication-messaging
content-social/chirp	browser-automation
content-social/clawdbites	media-processing
content-social/clawstin	content-publishing
content-social/coconala-seller	content-publishing
content-social/email-marketing-copy	communication-messaging
content-social/giphy	communication-messaging
content-social/hotmention	content-publishing
content-social/instaclaw	media-generation
content-social/instagram-poster	browser-automation
content-social/instapaper	content-publishing
content-social/job-description	content-publishing
content-social/klawdin	content-publishing
content-social/korean-claw	content-publishing
content-social/linkedin-automation	content-publishing
content-social/linkedin-scraper	content-publishing
content-social/nonopost	content-publishing
content-social/opentweet-x-poster	content-publishing
content-social/postfast	content-publishing
content-social/prompt-seller	travel-transport
content-social/resume-optimizer	media-processing
content-social/twitter	content-publishing
content-social/wechat-publisher	communication-messaging
content-social/x-post-automation	content-publishing
content-social/x-timeline-digest	content-publishing
content-social/x-trends-dev	content-publishing
content-social/xai-search	search-web
content-social/xbio	content-publishing
content-social/xiaohongshu-publisher	browser-automation
data-analytics/acp-rank	data-analytics
data-analytics/cochesnet-cli	data-analytics
data-analytics/creatordb-youtube-v3	data-analytics
data-analytics/csvtoexcel	data-analytics
data-analytics/dnfm-tracker	data-analytics
data-analytics/internet-failure-analysis-expert	data-analytics
data-analytics/moltext	data-analytics
data-analytics/qlik	data-analytics
data-analytics/qlik-cloud	data-analytics
data-analytics/qlik-cloud-skill	data-analytics
data-analytics/saas-revenue-tracker	data-analytics
data-analytics/sg-property-scraper	travel-transport
data-analytics/wakapi-sync-skill	data-analytics
data-integration/ai-news-collectors	knowledge-research
data-integration/auto-updater	devops-cloud
data-integration/deepread-ocr	media-processing
data-integration/download-tools	media-processing
data-integration/find-products	business-operations
data-integration/gonggong-hwpxskills-main	media-processing
data-integration/mixlab-solo-scope	knowledge-research
data-integration/ofdreader	media-processing
data-integration/pdftk-server	media-processing
data-integration/priceworld	business-operations
data-integration/telecom-agent-skill	communication-messaging
data-integration/turkey-news	knowledge-research
data-integration/update	devops-cloud
data-integration/x-hot-topics-daily	knowledge-research
developer-tools/coding-as-dressing	developer-tools
developer-tools/computer-vision-expert	developer-tools
developer-tools/content-moderation	security-compliance
developer-tools/conversation-summary-api	agent-core
developer-tools/data-reconciliation-exceptions	data-analytics
developer-tools/guardskills	security-compliance
developer-tools/install-scientify	knowledge-research
developer-tools/minimax-mcp	integrations-connectors
developer-tools/moltblock	developer-tools
developer-tools/moltcheck	security-compliance
developer-tools/opensysinfo	developer-tools
developer-tools/opensysinfo-skill	developer-tools
developer-tools/pangolin-utils	developer-tools
developer-tools/prompt-injection-guard	security-compliance
developer-tools/record	media-generation
developer-tools/skill-cleaner	security-compliance
developer-tools/skill-doctorbot-healthcheck-free	developer-tools
developer-tools/tmux-terminal	developer-tools
developer-tools/ui-ux-pro-max-plus	data-analytics
developer-tools/volcengine-config	developer-tools
development-system-tools/clawdbot-filesystem	developer-tools
development-system-tools/clawdbot-security-suite	security-compliance
development-system-tools/dht11-temp	developer-tools
development-system-tools/filesystem	developer-tools
development-system-tools/gopass	developer-tools
development-system-tools/let-me-know	communication-messaging
development-system-tools/parallel-task-executor	developer-tools
development-system-tools/vibetunnel	data-analytics
development-workflows/claude-tmux-runner	agent-core
development-workflows/claude-usage-checker	developer-tools
development-workflows/clrun	developer-tools
development-workflows/coder	developer-tools
development-workflows/cursor-cli-headless	agent-orchestration
development-workflows/evolve	security-compliance
development-workflows/foundry	knowledge-research
development-workflows/freeride-opencode	agent-orchestration
development-workflows/git-pushing	developer-tools
development-workflows/gitflow	devops-cloud
development-workflows/github-issue-creator	developer-tools
development-workflows/go-security-vulnerability	security-compliance
development-workflows/gov-apply	developer-tools
development-workflows/iam	developer-tools
development-workflows/opencode-controller	agent-orchestration
development-workflows/pr-commit-workflow	developer-tools
development-workflows/pr-review-loop	developer-tools
development-workflows/schema-markup-generator	content-publishing
development-workflows/securevibes-scanner	security-compliance
development-workflows/skill-doctorbot-ci-validator	knowledge-research
development-workflows/snek	developer-tools
development-workflows/uv-priority	developer-tools
development-workflows/vhs-recorder	developer-tools
devops-infrastructure/astra-docker	devops-cloud
devops-infrastructure/awscli	devops-cloud
devops-infrastructure/bun-runtime	devops-cloud
devops-infrastructure/clawdbot-macos-build	developer-tools
devops-infrastructure/cloudmonkey	devops-cloud
devops-infrastructure/deterministic-controller	agent-core
devops-infrastructure/docker-essentials-1-0-0	media-generation
devops-infrastructure/git-crypt-backup	devops-cloud
devops-infrastructure/godaddy	devops-cloud
devops-infrastructure/k8s-backup	devops-cloud
devops-infrastructure/k8s-certs	devops-cloud
devops-infrastructure/lybic-sandbox	devops-cloud
devops-infrastructure/mcp-ssh-manager	devops-cloud
devops-infrastructure/n8n-automation	devops-cloud
devops-infrastructure/omarchy	security-compliance
devops-infrastructure/openclaw-auto-updater	devops-cloud
devops-infrastructure/openclaw-server-secure-skill	security-compliance
devops-infrastructure/openclaw-update	devops-cloud
devops-infrastructure/openclaw-update-skill	devops-cloud
devops-infrastructure/openclaw-updater-v2	devops-cloud
devops-infrastructure/openclaw-workspace-governance-installer	devops-cloud
devops-infrastructure/proxymock	devops-cloud
devops-infrastructure/railway-deploy	travel-transport
devops-infrastructure/saas-builder	data-analytics
devops-infrastructure/sandboxer-tmux	devops-cloud
devops-infrastructure/sys-updater	devops-cloud
devops-infrastructure/tencentcloud-lighthouse-skill	integrations-connectors
devops-infrastructure/toolguard-daemon-control	devops-cloud
finance-data-services/data-structure	data-analytics
finance-data-services/db-query	devops-cloud
finance-data-services/edinet-mcp	finance-markets
finance-data-services/japanfinance-agent	finance-markets
finance-data-services/jquants-mcp	finance-markets
finance-data-services/ned-analytics	data-analytics
finance-data-services/s2s-forecasting-expert	finance-markets
finance-data-services/stock-price-checker	finance-markets
finance-data-services/tdnet-disclosure-mcp	finance-markets
hardware-iot/ardupilot	smart-home-iot
hardware-iot/claw-mouse	smart-home-iot
hardware-iot/fox-lights	smart-home-iot
hardware-iot/mijia	smart-home-iot
hardware-iot/molt-mouse	smart-home-iot
hardware-iot/nano-banana-korean-rendering	smart-home-iot
hardware-iot/screen-monitor	smart-home-iot
information-research/afrexai-competitor-monitor	knowledge-research
information-research/airbnb	travel-transport
information-research/arxiv-paper-reviews	knowledge-research
information-research/arxiv-watcher	knowledge-research
information-research/arxiv-watcher-vigo	knowledge-research
information-research/baidu-baike	knowledge-research
information-research/baidu-baike-search	knowledge-research
information-research/baidu-milan-winter-olympics-2026	knowledge-research
information-research/bbc-news	knowledge-research
information-research/birdnet	knowledge-research
information-research/blog-writer	content-publishing
information-research/catalog	agent-core
information-research/ceorater	finance-markets
information-research/dash-cog	data-analytics
information-research/dellight-cro-revenue-ops	data-analytics
information-research/fomo-research-skill	knowledge-research
information-research/geepers-corpus	knowledge-research
information-research/geo-ip	knowledge-research
information-research/gousto	knowledge-research
information-research/idealista-cli	knowledge-research
information-research/ironclaw-lead-enrichment	communication-messaging
information-research/ironclaw-pipeline-analytics	data-analytics
information-research/japan-news-mcp	finance-markets
information-research/jtbd-analyzer	knowledge-research
information-research/jwdiario	knowledge-research
information-research/k-cinema-bridge	knowledge-research
information-research/ket	knowledge-research
information-research/kimi-usage-monitor	knowledge-research
information-research/kradleverse-act	knowledge-research
information-research/kradleverse-join	knowledge-research
information-research/kradleverse-observe	knowledge-research
information-research/localrank-agent-skills	content-publishing
information-research/location-context	knowledge-research
information-research/nostr-plantr	knowledge-research
information-research/observe	knowledge-research
information-research/product-research	communication-messaging
information-research/proxy-balance	knowledge-research
information-research/qweather	knowledge-research
information-research/revenuecat	finance-markets
information-research/slashbot-news	knowledge-research
information-research/sr1	knowledge-research
information-research/tidbyt-status	data-analytics
information-research/tnbc-research-swarm	agent-orchestration
information-research/wilma-triage	communication-messaging
information-research/zoomin-scraper-recklessop	browser-automation
integrations-apis/autotask-mcp	devops-cloud
integrations-apis/clawdhub-1-0-0	integrations-connectors
integrations-apis/clawdhub-copy	integrations-connectors
integrations-apis/clawhub-6yr3b	integrations-connectors
integrations-apis/clawingtrap	games-entertainment
integrations-apis/coding-agent-user-rules	developer-tools
integrations-apis/devtopia	integrations-connectors
integrations-apis/geeksdobyte-motivation-skill	integrations-connectors
integrations-apis/google-maps-grounding-lite-mcp	integrations-connectors
integrations-apis/grok-search	search-web
integrations-apis/leak	integrations-connectors
integrations-apis/moltbook-optimizer	content-publishing
integrations-apis/skill-installer	devops-cloud
integrations-apis/test-new-skill	integrations-connectors
integrations-apis/test-simple-abc	integrations-connectors
integrations-apis/vassili-clawhub-cli	integrations-connectors
knowledge-research/beads	agent-core
knowledge-research/deep-research	knowledge-research
knowledge-research/deep-researchj	knowledge-research
knowledge-research/deep-think	knowledge-research
knowledge-research/graphiti	knowledge-research
knowledge-research/hybrid-memory	knowledge-research
knowledge-research/intodns	communication-messaging
knowledge-research/kb-search	knowledge-research
knowledge-research/mobb-vulnerabilities-fixer	security-compliance
knowledge-research/openviking	agent-core
knowledge-research/parallel-deep-research	search-web
knowledge-research/qverisai	knowledge-research
knowledge-research/searxng-local	search-web
knowledge-research/searxng-metasearch	search-web
knowledge-research/searxng-self-hosted	search-web
knowledge-research/specification-extractor	knowledge-research
knowledge-research/zotero-sholar	knowledge-research
media-content/data-viz	data-analytics
media-content/instagram-reels	media-processing
media-content/pptx-pdf-font-fix	media-processing
media-content/printer	media-processing
media-content/webpage-screenshot	browser-automation
media-content/winamp	games-entertainment
media-content/x-trends	content-publishing
media-content/youtube-shorts	media-generation
media-entertainment/ahmed	games-entertainment
media-entertainment/anthropic-frontend-design	developer-tools
media-entertainment/apple-media	games-entertainment
media-entertainment/arr-all	integrations-connectors
media-entertainment/bililidownloader	media-processing
media-entertainment/catime	games-entertainment
media-entertainment/chess	games-entertainment
media-entertainment/chromecast-control	games-entertainment
media-entertainment/claw-werewolf-live	games-entertainment
media-entertainment/clawclashapp	games-entertainment
media-entertainment/clawos	agent-orchestration
media-entertainment/clawtunes	games-entertainment
media-entertainment/creative-ideator	games-entertainment
media-entertainment/cultivation-chronicle-cn	games-entertainment
media-entertainment/eachlabs-music	media-generation
media-entertainment/frinkiac	games-entertainment
media-entertainment/frontend-design-1-0-0	developer-tools
media-entertainment/frontend-design-2	developer-tools
media-entertainment/frontend-design-3	developer-tools
media-entertainment/gamifyhost	games-entertainment
media-entertainment/glowskin-promo	content-publishing
media-entertainment/hitchhikers-guide	games-entertainment
media-entertainment/inworld-tts	media-generation
media-entertainment/landing-page-roast	content-publishing
media-entertainment/lidarr	integrations-connectors
media-entertainment/lyrics-search	media-processing
media-entertainment/molt-city	games-entertainment
media-entertainment/molterstrike	games-entertainment
media-entertainment/moltmon	games-entertainment
media-entertainment/podcast-generation	media-generation
media-entertainment/product-image-generator	media-generation
media-entertainment/reachy-mini	smart-home-iot
media-entertainment/renderful-generation	media-generation
media-entertainment/roast-games	games-entertainment
media-entertainment/roofing-knowledge-mentor	knowledge-research
media-entertainment/scrapyard	games-entertainment
media-entertainment/screenshot-capture	media-processing
media-entertainment/seo-content-engine	content-publishing
media-entertainment/skanetrafiken	travel-transport
media-entertainment/sonos	games-entertainment
media-entertainment/speedtest	developer-tools
media-entertainment/spongo	games-entertainment
media-entertainment/spotify	games-entertainment
media-entertainment/stremio-cast	games-entertainment
media-entertainment/tiktok-product-promotion	content-publishing
media-entertainment/trackyard	games-entertainment
media-entertainment/vap-media	media-generation
media-entertainment/vap-multimedia-generation	media-generation
media-entertainment/vector-robot	smart-home-iot
media-entertainment/vehicle-tracker	productivity-personal
media-entertainment/video-watcher	media-processing
media-entertainment/whispers-from-the-star	games-entertainment
media-entertainment/wiim	games-entertainment
media-entertainment/wishfinity	business-operations
media-entertainment/wps-punchclock	productivity-personal
media-entertainment/youtube-scrapper	media-processing
media-processing/ai-podcast	media-processing
media-processing/avatar-video-messages	communication-messaging
media-processing/bilibili-youtube-watcher	media-processing
media-processing/docling	search-web
media-processing/docstrange	media-processing
media-processing/douyin-video-fetch	media-processing
media-processing/eachlabs-image-edit	media-generation
media-processing/espeak-ng	media-generation
media-processing/gemini-image-proxy	media-generation
media-processing/homepod-tts	media-generation
media-processing/image-magik-resize	media-processing
media-processing/image-resize	media-processing
media-processing/inkjet	media-processing
media-processing/insaiai-intelligent-editing	media-processing
media-processing/instagram-reel-downloader-whatsapp	communication-messaging
media-processing/local-vosk	communication-messaging
media-processing/masonry-generate-image-and-video	media-generation
media-processing/nano-banana-pro-image-gen	media-generation
media-processing/nanobanana-pro-fallback	media-generation
media-processing/notebooklm-cli-cookies	media-processing
media-processing/openclaw-qr-code	communication-messaging
media-processing/overleaf-skill	media-processing
media-processing/qr-code	media-generation
media-processing/qr-code-intelligence	media-generation
media-processing/qr-code-pro	media-generation
media-processing/sapi-tts	media-generation
media-processing/seedance-guide	media-generation
media-processing/seeddance-ai-video	media-generation
media-processing/svg-draw	media-generation
media-processing/telegram-voice-to-voice-macos	communication-messaging
media-processing/tiangong-notebooklm-cli	communication-messaging
media-processing/tiktok-crawling	media-processing
media-processing/transcribee	media-processing
media-processing/veo	media-generation
media-processing/veo-video-generator	media-generation
media-processing/video-download-faas	media-processing
media-processing/whisnap	media-processing
media-processing/youtube-summary	media-processing
media-processing/youtube-transcript-analyzer	media-processing
media-processing/youtube-voice-summarizer-elevenlabs	media-generation
media-processing/youtube-watcher	media-processing
media-processing/youtube-watcherkx	media-processing
media_content/.ruff_cache	media-processing
mobile-design/android-adb	developer-tools
mobile-design/apple-hig	developer-tools
mobile-design/asc-release-flow	travel-transport
mobile-design/axe-devtools	developer-tools
mobile-design/fivem-dev	devops-cloud
mobile-design/godot-dev-guide	developer-tools
mobile-design/guicountrol	browser-automation
mobile-design/hidpi-mouse	developer-tools
mobile-design/ios-view-generator	developer-tools
mobile-design/lb-motion-skill	developer-tools
mobile-design/lb-shadcn-ui-skill	data-analytics
mobile-design/raycast	knowledge-research
mobile-design/react-native-update	devops-cloud
mobile-design/remix-api-key-auth	developer-tools
mobile-design/symbolpicker	developer-tools
productivity-automation/anki-connect	productivity-personal
productivity-automation/arya-reminders	productivity-personal
productivity-automation/caldav-calendar-1-0-1	productivity-personal
productivity-automation/calendar	productivity-personal
productivity-automation/cron-retry	devops-cloud
productivity-automation/health-sync	productivity-personal
productivity-automation/healthcheck	knowledge-research
productivity-automation/intermittent-fasting-skill	communication-messaging
productivity-automation/joan-workflow	productivity-personal
productivity-automation/lore	knowledge-research
productivity-automation/memory	agent-core
productivity-automation/memory-complete	agent-core
productivity-automation/memory-maintenance	agent-core
productivity-automation/mentx-doctor	productivity-personal
productivity-automation/open-ralph	developer-tools
productivity-automation/remember-me	productivity-personal
productivity-automation/staratheris-arya-reminders	productivity-personal
productivity-automation/task-scheduler	communication-messaging
productivity-automation/water-coach	data-analytics
productivity-task-management/birthday-reminder	agent-core
productivity-task-management/calctl	agent-core
productivity-task-management/clawkeeper	agent-core
productivity-task-management/clawpm	agent-core
productivity-task-management/family-todo-management	agent-core
productivity-task-management/nag	agent-core
productivity-task-management/telegram-todolist	agent-core
productivity-task-management/timecamp	agent-core
productivity-task-management/todoist-rs	agent-core
productivity-task-management/todoist-td	agent-core
productivity-tools/ai-interview-simulator-candaigo	productivity-personal
productivity-tools/airshelf	business-operations
productivity-tools/amap	productivity-personal
productivity-tools/argos-product-research	knowledge-research
productivity-tools/bring-shopping	communication-messaging
productivity-tools/code-docs-generator	productivity-personal
productivity-tools/dupe	productivity-personal
productivity-tools/fill-content-by-mixlab	productivity-personal
productivity-tools/flightclaw	travel-transport
productivity-tools/futa-tracker	travel-transport
productivity-tools/get-weather	knowledge-research
productivity-tools/gold-price-mcp	productivity-personal
productivity-tools/irish-takeaway	browser-automation
productivity-tools/mal-lookup	productivity-personal
productivity-tools/navifare-hidden-flight-deals	travel-transport
productivity-tools/nlb	productivity-personal
productivity-tools/openclaw-reportstudio-community	media-processing
productivity-tools/rankaj	knowledge-research
productivity-tools/rea-search	travel-transport
productivity-tools/report-generator	data-analytics
productivity-tools/rv-measure	productivity-personal
productivity-tools/strava-python	productivity-personal
productivity-tools/trash-audit	productivity-personal
productivity-tools/vnsh	productivity-personal
productivity-tools/website-builder	business-operations
productivity/adhd-daily-planner	productivity-personal
productivity/ai-meeting-room	developer-tools
productivity/asdasd	integrations-connectors
productivity/banshee-s-last-cry	games-entertainment
productivity/better-notion	productivity-personal
productivity/bring	productivity-personal
productivity/calendar-reminders	productivity-personal
productivity/case-record-socialwork	productivity-personal
productivity/cognary-ai-tasks	agent-core
productivity/confirm-form	developer-tools
productivity/craft	agent-core
productivity/create-videoconference	communication-messaging
productivity/d4-world-boss	productivity-personal
productivity/dev-chronicle	media-processing
productivity/focus-mode	agent-core
productivity/freedcamp-agent-skill	productivity-personal
productivity/gamification-xp	productivity-personal
productivity/get-focus-mode	productivity-personal
productivity/grazy	productivity-personal
productivity/knowledge-graph	agent-core
productivity/makeovern	productivity-personal
productivity/meetup-planner	productivity-personal
productivity/no-nonsense-tasks	agent-core
productivity/notectl	productivity-personal
productivity/notion-clipper-skill	productivity-personal
productivity/pandic-office	media-processing
productivity/pear-apple	productivity-personal
productivity/pear-icloud	productivity-personal
productivity/personal-ideas	communication-messaging
productivity/personal-love	communication-messaging
productivity/personal-notes	communication-messaging
productivity/personal-travel	travel-transport
productivity/planka	productivity-personal
productivity/planka-cli	productivity-personal
productivity/political-struggle	knowledge-research
productivity/pomodoro-bot	productivity-personal
productivity/pref0	productivity-personal
productivity/probar	communication-messaging
productivity/supervisor-proposer	productivity-personal
productivity/timely	productivity-personal
productivity/timer	productivity-personal
productivity/truetime	productivity-personal
productivity/variflight-aviation	travel-transport
productivity/whispers-from-the-star-cn	games-entertainment
productivity/writing-plans-2	productivity-personal
productivity/xuezh	developer-tools
productivity/yoebao-bazi	finance-markets
productivity/yoebao-yao	finance-markets
smart-home-iot/bambu-local	smart-home-iot
smart-home-iot/dtek-light	smart-home-iot
smart-home-iot/google-home-control	smart-home-iot
smart-home-iot/lan-media-server	smart-home-iot
smart-home-iot/midea-ac	smart-home-iot
smart-home-iot/nostr-weather	smart-home-iot
smart-home-iot/nzbget	smart-home-iot
smart-home-iot/openclaw-robotics	smart-home-iot
smart-home-iot/overseerr	smart-home-iot
smart-home-iot/tautulli	smart-home-iot
smart-home-iot/weather-esp32	smart-home-iot
system-developer-tools/async-web-search	search-web
system-developer-tools/clawctl	agent-orchestration
system-developer-tools/clawion	agent-orchestration
system-developer-tools/moltbook-validator	developer-tools
system-developer-tools/moltworld-dashboard-deploy	devops-cloud
system-developer-tools/ns-trains	travel-transport
system-developer-tools/railil	travel-transport
system-developer-tools/server-monitor	devops-cloud
system-developer-tools/skill-railil	travel-transport
system-developer-tools/system-monitor	devops-cloud
system-developer-tools/wiz-light-control	smart-home-iot
trustskill/.pytest_cache	security-compliance
trustskill/references	security-compliance
trustskill/scripts	security-compliance
trustskill/security_categories	security-compliance
trustskill/security_scan_results	security-compliance
trustskill/src	security-compliance
trustskill/tests	security-compliance
utilities/aholake-expense-tracker	productivity-personal
utilities/al-khanjry-bus	communication-messaging
utilities/applicant-screening	productivity-personal
utilities/beijing-tech-finance	finance-markets
utilities/calorie-counter	productivity-personal
utilities/carddav-contacts	productivity-personal
utilities/clawd-presence	agent-core
utilities/clawdbot-skill-voice-wake-say	media-processing
utilities/code-task-generator	developer-tools
utilities/email-best-practices	communication-messaging
utilities/envios	productivity-personal
utilities/expense-tracker	productivity-personal
utilities/file-organizer	developer-tools
utilities/fortune-oracle	finance-markets
utilities/gogcli	communication-messaging
utilities/half-full	productivity-personal
utilities/healthy-eating	productivity-personal
utilities/icloud-findmy	productivity-personal
utilities/jaen	developer-tools
utilities/lofy-career	communication-messaging
utilities/lofy-fitness	data-analytics
utilities/mindfulness-meditation	productivity-personal
utilities/norman-categorize-transactions	finance-markets
utilities/penguin-pet	productivity-personal
utilities/personal-finance	productivity-personal
utilities/pocketsmith	finance-markets
utilities/pocketsmith-skill	finance-markets
utilities/rescuetime	data-analytics
utilities/snipit	developer-tools
utilities/solo-cli	finance-markets
utilities/test-wa	communication-messaging
utilities/vocabulary-builder	productivity-personal
utilities/voice-wake-say	media-processing
utilities/voicenotes-official	media-processing
utilities/whatsapp-local-endpoints-router	communication-messaging
utilities/zenplus-health	productivity-personal
web-communication-tools/agent-browser-clawdbot-bak-2026-01-28t18-01-09-10-30	browser-automation
web-communication-tools/airc	communication-messaging
web-communication-tools/clawatar	media-generation
web-communication-tools/dc-weather	knowledge-research
web-communication-tools/happy-hues	developer-tools
web-communication-tools/radarr	integrations-connectors
web-communication-tools/sonarr	integrations-connectors
web-communication-tools/spacex	knowledge-research
web-communication-tools/spots	search-web
web-communication-tools/system-resource-monitor	devops-cloud
web-communication-tools/tg-miniapp	developer-tools
web-communication-tools/tg-smart-cta	communication-messaging
web-communication-tools/volcengine-web-search	search-web
web-communication-tools/weather-open-meteo	knowledge-research
web-communication-tools/yutori-web-research	search-web
web-search/arxiv	knowledge-research
web-search/browser-use-api	search-web
web-search/ddg-search	search-web
web-search/deepwiki	search-web
web-search/flaresolverr	search-web
web-search/google-web-search	search-web
web-search/harpa-ai	search-web
web-search/metaso-search-v2	search-web
web-search/n2-free-search	search-web
web-search/parallel-extract	search-web
web-search/parallel-search	search-web
web-search/pcap-analyzer	security-compliance
web-search/readeck	search-web
web-search/serper-v	search-web
web-search/snaprender	search-web
web-search/super-websearch-realtime	search-web
web-search/tavily-search	search-web
web-search/tavily-search-1-0-0	search-web
web-services/camino-travel-planner	travel-transport
web-services/canvs	developer-tools
web-services/clawmart-browse	integrations-connectors
web-services/cobraclaw	games-entertainment
web-services/cold-email-personalization	content-publishing
web-services/google-flights	travel-transport
web-services/google-maps-leadgen-skill	communication-messaging
web-services/hevy-workouts	productivity-personal
web-services/investment-advisor	finance-markets
web-services/letterboxd-tracker	games-entertainment
web-services/mcporter-railway-query	travel-transport
web-services/mcporter-railway-query-repo	travel-transport
web-services/moltbook-interact	content-publishing
web-services/moltsci	knowledge-research
web-services/momentspost	content-publishing
web-services/nostr-nak	integrations-connectors
web-services/pepsi-or-coke-mcp	games-entertainment
web-services/pi-health	smart-home-iot
web-services/plsreadme	content-publishing
web-services/primattography-color-science	developer-tools
web-services/productboard-release	business-operations
web-services/skiplagged-flights	travel-transport
web-services/sure	finance-markets
web-services/tenzing-moltbook	content-publishing
web-services/tg-checkin	communication-messaging
web-services/travel-manager	travel-transport
web-services/trein	travel-transport
web-services/twinfold	content-publishing
web-services/upnote	productivity-personal
web-services/veadk-skills	integrations-connectors
web-services/wilma	integrations-connectors
web-services/wpclaw-lite	business-operations
web-services/wyoming-clawdbot	smart-home-iot
